{
    "name": "ost003d_small",
    "n_row": 97,
    "n_col": 97,
    "layout": [
        "@@@@@@@@@@@@@@@@@@@@@@@@@@@@@@@@@@@@@@@@@@@@@@@@@@@@@@@@@@@@@@@@@@@@@@@@@@@@@@@@@@@@@@@@@@@@@@@@@",
        "@@@@@@@@@@@@@@@@@@@@@@@@@@@@@@@@@@@@@@@@@@@@@@@@@@@@@@@@@@@@@@@@@@@@@@@@@@@@@@@@@@@@@@@@@@@@@@@@@",
        "@@@@@@@@@@@@@@@@@@@@@@@@@@@@@@@@@@@@@@@@@@@@@@@@@@@@@@@@@@@@@@@@@@@@@@@@@@@@@@@@@@@@@@@@@@@@@@@@@",
        "@@@@@@@@@@@@@@@@@@@@@@@@@@@@@@@@@@@@@@@@@@@@@@@@@@@@@@@@@@@@@@@@@@@@@@@@@@@@@@@@@@@@@@@@@@@@@@@@@",
        "@@@@@@@@@@@@@@@@@@@@@@@@@@@@@@@@@@@@@@@@@@@@@@@@@@@@@@@@@@@@@@@@@@@@@@@@@@@@@@@@@@@@@@@@@@@@@@@@@",
        "@@@@@@@@@@@@@@@@@@@@@@@@@@@@@@@@@@@@@@@@@@@@@@@@@@@@@@@@@@@@@@@@@@@@@@@@@@@@@@@@@@@@@@@@@@@@@@@@@",
        "@@@@@@@@@@@@@@@@@@@@@@@@@@@@@@@@@@@@@@@@@@@@@@@@@@@@@@@@@@@@@@@@@@@@@@@@@@@@@@@@@@@@@@@@@@@@@@@@@",
        "@@@@@@@@@@@@@@@@@@@@@@@@@@@@@@@@@@@@@@@@@@@@@@@@@@@@@@@@@@@@@@@@@@@@@@@@@@@@@@@@@@@@@@@@@@@@@@@@@",
        "@@@@@@@@@@@@@@@@@@@@@@@@@@@@@@@@@@@@@@@@@@@@@@@@@@@@@@@@@@@@@@@@@@@@@@@@@@@@@@@@@@@@@@@@@@@@@@@@@",
        "@@@@@@@@@@@@@@@@@@@@@@@@@@@@@@@@@@@@@@@@@@@@@@@@@@@@@@@@@@@@@@@@@@@@@@@@@@@@@@@@@@@@@@@@@@@@@@@@@",
        "@@@@@@@@@@@@@@@@@@@@@@@@@@@@@@@@@@@@@@@@@@@@@@@@@@@@@@@@@@@@@@@@@@@@@@@@.@@@@@@@@@@@@@@@@@@@@@@@@",
        "@@@@@@@@@@@@@@@@@@@@@@@@@@@@@@@@@@@@@@@@@@@@@@@@@@@@@@@@@@@@@@@@@@@@@@@@...@@@@@@@@@@@@@@@@@@@@@@",
        "@@@@@@@@@@@@@@@@@@@@@@@@@@@@@@@@@@@@@@@@@@@@@@@@@@@@@@@@@@@@@@@@@@@@@@@@.....@@@@@@@@@@@@@@@@@@@@",
        "@@@@@@@@@@@@@@@@@@@@@@@@@@@@@@@@@@@@@@@@@@@@@@@@@@@@@@@@@@@@@@@@@@@@@@@@@......@@.@@@@@@@@@@@@@@@",
        "@@@@@@@@@@@@@@@@@@@@@@@@@@@@@@@@@@@@@@@@@@@@@@@@@@@@@@@@@@@@@@@@@@@@@@@@............@@@@@@@@@@@@@",
        "@@@@@@@@@@@@@@@@@@@@@@@@@@@@@@@@@@@@@@@@@@@@@@@@@@@@@@@@@@@@@@@@@@@@@@@............@@@@@@@@@@@@@@",
        "@@@@@@@@@@@@@@@@@@@@@@@@@@@@@@@@@@@@@@@@@@@@@@@@@@@@@@@@@@@@@@@@@@@@@@@.............@@@@@@@@@@@@@",
        "@@@@@@@@@@@@@@@@@@@@@@@@@@@@@@@@@@@@@@@@@@@@@@@@@@@@@@@@@@@@@@@@@@@@@@.......@@@@.@@@@@@@@@@@@@@@",
        "@@@@@@@@@@@@@@@@@@@@@@@@@@@@@@@@@@@@@@@@@@@@@@@@@@@@@@@@@@@@@@@@@@@@@@......@@@@@@@@@@@@@@@@@@@@@",
        "@@@@@@@@@@@@@@@@@@@@@@@@@@@@@@@@@@@@@@@@@@@@@@@@@@@@@@@@@@@@@@@@@@@@@.......@@@@@@@@@@@@@@@@@@@@@",
        "@@@@@@@@@@@@@@@@@@@@@@@@@@@@@@@@@@@@@@@@@@@@@@@@@@@@@@@@@@@@@@@@@@@@@.......@@@@@@@@@@@@@@@@@@@@@",
        "@@@@@@@@@@@@@@@@@@@@@@@@@@@@@@@@@@@@@@@@@@@@@@@@@@@@@@@@@@@@@@@@@@@@.........@@@@@@@@...@@@@@@@@@",
        "@@@@@@@@@@@@@@@@@@@@@@@@@@@@@@@@@@@@@@@@@@@@@@@@@@@@@@@@@@@@@@@@@@.......@@..@@@@@@.....@@@@@@@@@",
        "@@@@@@@@@@@@@@@@@@@@@@@@@@@@@@@@@@@@@@@@@@@@@@@@@@@@@@@@@@@@@@@@@.......@@@@.@@@@@.....@@@@@@@@@@",
        "@@@@@@@@@@@@@@@@@@@@@@@@@@@@@@@@@@@@@@@@@@@@@@@@@@@@@@@@@@@@@@@@.........@@..@@@......@@@@@@@@@@@",
        "@@@@@@@@@@@@@@@@@@@@@@@@@@@@@@@@@@@@@@@@@@@@@@@@@@@@@@@@@@@@@@@..........@..........@@@@@@@@@@@@@",
        "@@@@@@@@@@@@@@@@@@@@@@@@@@@@@@@@@@@@@@@@@@@@@@@@@@@@@@@@@@@@@@@...................@@@@@@@@@@@@@@@",
        "@@@@@@@@@@@@@@@@@@@@@@@@@@@@@@@@@@@@@@@@@@@@@@@@@@@@@@@@@@@@@@...................@@@@@@@@@@.@@@@@",
        "@@@@@@@@@@@@@@@@@@@@@@@@@@@@@@@@@@@@@@@@@@@@@@@@@@@@@@@@@@@@@@.................@@@@@@@@@@@@.@@@@@",
        "@@@@@@@@@@@@@@@@@@@@@@@@@@@@@@@@@@@@@@@@@@@@.....@@..@@@@@@@@..@@........@@.....@@@@@..@@....@@@@",
        "@@@@@@@@@@@@@@@@@@@@@@@@@@@@@@@@@@@@@@@@.........@@@.....@@@@.@@@@......@@@@@.@@@@@@.........@@@@",
        "@@@@@@@@@@@@@@@@@@@@@@@@@@@@@@@@@@@@@@@@...........@......@@@@@@@@......@@@@@@@@@@@@..........@@@",
        "@@@@@@@@@@@@@@@@@@@@@@@@@@@@@@@@@@@@@.....................@@@@@@@@@.....@@@@@@@.@@@@......@@@@.@@",
        "@@@@@@@@@@@@@@@@@@@@@@@@@@@@@@@@@@@@.....................@@@@.@@@@@......@@@@@...@........@@@@.@@",
        "@@@@@@@@@@@@@@@@@@@@@@@@@@@@@@@@@@@.....................@@@@@..@@@@@....@@@@@.............@@@..@@",
        "@@@@@@@@@@@@@@@@@@@@@@@@@@@@@@@@@@@@@...................@@@@....@@@@@...@@@@@..................@@",
        "@@@@@@@@@@@@@@@@@@@@@@@@@@@@@@@@@.@@.....................@@....@@@@@@@@...@@@@..................@",
        "@@@@@@@@@@@@@@@@@@@@@@@@@@@@@@@@........................@@....@@@@@@@@....@@@@..................@",
        "@@@@@@@@@@@@@@@@@@@@@@@@@@@@@@@@@.......................@....@@@@@@@@@......@@.......@@@....@@@@@",
        "@@@@@@@@@@@@@@@@@@@@@@@@@@@@@@@@@..............@............@@@@..@@@@......@@.......@@.....@@@@.",
        "@@@@@@@@@@@@@@@@@@@@@@@@@@@@@@@@@..............@@@.........@@@@....@@@@.....................@....",
        "@@@@@@@@@@@@@@@@@@@@@@@@@@@@@@@@@@@..........@@@@..........@.......@@@@..........................",
        "@@@@@@@@@@@@@@@@@@@@@@@@@@@@@@@@@@@........@@@@@....................@@.......@@..................",
        "@@@@@@@@@@@@@@@@@@@@@@@@@@@@@@@@@@@.......@@@@@@....................@@.......@@@.................",
        "@@@@@@@@@@@@@@@@@@@@@@@@@@@@@@@@@@@......@@.........................@@......@@@@.................",
        "@@@@@@@@@@@@@@@@@@@@@@@@@@@@@@@@@@@@@....@@..............@..........@@......@@@@..@@@@...@@@@....",
        "@@@@@@@@@@@@@@@@@@@@@@@@@@@@@@@@@@@@.....@@@.........................@@.....@@@@.@@@@@@@.@@@@@...",
        "@@@@@@@@@@@@@@@@@@@@@@@@@@@@@@@@@@@@.....@@@............@@..........@@@......@@@@@@@@@@..@@@@@.@@",
        "@@@@@@@@@@@@@@@@@@@@@@@@@@@@@@@@@@@@....@@@.....@.......@@..........@@@@......@@@@@@@@@@@@@@@@@@@",
        "@@@@@@@@@@@@@@@@@@@@@@@@@@@@@.@@.@@....@@@............@@@@..........@@@@......@@@@@@@@@@@@@@@@@@@",
        "@@@@@@@@@@@@@@@@@@@@@@@@@@@@@..........@@@@.........@@@@@............@@.......@@@.@@@@@@@@@@@.@@@",
        "@@@@@@@@@@@@@@@@@@@@@@@@@@@@@..........@@@@............@............@@@.......@@...@@@..@@@...@@@",
        "@@@@@@@@@@@@@@@@@@@@@@@@@@@@@...........@@............@@............@@.......@@@...@@@..@@@...@@@",
        "@@@@@@@@@@@@@@@@@@@@@@@@@@@@@.@@@..............@.@@@..@@............@@.......@@@....@@..@@@...@@@",
        "@@@@@@@@@@@@@@@@@@@@@@@@@@@@@@@@@@............@@....@@@.............@@.......@@@@...............@",
        "@@@@@@@@@@@@@@@@@@@@@@@@@@@@@@@@@@...........@@@@@@@@@.............@@........@@..................",
        "@@@@@@@@@@@@@@@@@@@@@@@@@@@@@@@@@............@@@@@.................@@...........................@",
        "@@@@@@@@@@@@@@@@@@@@@@@@@@@@@@@@@@............@@@.................@@@.......................@@@@@",
        "@@@@@@@@@@@@@@@@@@@@@@@@@@@@@@@@@@...............................@@@@......@@@.......@@@....@@@@@",
        "@@@@@@@@@@@@@@@@@@@@@@@@@@@@@@@@@@...............................@@@@......@@@@@......@@......@@@",
        "@@@@@@@@@@@@@@@@@@@@@@@@@@@@@@@@.................................@@@@......@@@@@................@",
        "@@@@@@@@@@@@@@@@@@@@@@@@@@@@@.@@@...............................@@@........@@@@.................@",
        "@@@@@@@@@@@@@@@@@@@@@@@@@@@....@@..............................@@@.........@@@...............@.@@",
        "@@@@@@@@@@@@@@@@@@@@@@@@@@............@.......................@@@.........@@@@...@..........@@@@@",
        "@@@@@@@@@@@@@@@@@@@@@@@@...........@..@@@@@@.................@@@..........@@@@@.@@@@........@@@@@",
        "@@@@@@@@@@@@@@@@@@@@@@@...........@@@@@@@@@@@..........@@.@@@@@..........@@@@@@@@@@@........@@@@@",
        "@@@@@@@@@@@@@@@@@@@@@@.............@@@@@@@@@@........@@@@@@@@@........@@@@@@@@@@@@@@@........@@@@",
        "@@@@@@@@@@@@@@@@@@@@@@....@@@.......@@@@@@@@......@@@@@@@@@@@..........@@@...@@@@@@@@........@@@@",
        "@@@@@@@@@@@@@@@@@@@@@.....@@@@......@@@@@@@@@@.@@@@@@@@@@@@@@.........@@@.....@@@@@@@@.@..@@.@@@@",
        "@@@@@@@@@@@@@@@@@@@.......@@@@......@@...@@@@@@@@@@@@@@@...............@......@@@@@@@@@@@@@@@@@@@",
        "@@@@@@@@@@@@@@@@@@.........@@@.....@@@.....@.@@@@@@....@............@...........@.@..@@@@@@@@@@@@",
        "@@@@@@@@@@@@@@@@..................@@@...........@@................@@@@...............@@@@@@@@@@@@",
        "@@@@@@@@@@@@@@....................@@............@@.............@@.@@@................@@@@@@@@@@@@",
        "@@@@@@@@@@@@@@...................@@@..........................@@@@@@.................@@@@@@@@@@@@",
        "@@@@@@@@@@@@@...................@@@..........................@@@@@@...................@@@@@@@@@@@",
        "@@@@@@@@@@@@@@............@@@..@@@@..........................@@@@@.........@@.........@@@@@@@@@@@",
        "@@@@@@@@@@@@@@@...........@@@@.@@@@..........................@@@@@.........@@@.......@@@@@@@@@@@@",
        "@@@@@@@@@@@@@@@...........@@@@@@@..............@@@@...........@.@@@@........@@......@@@@@@@@@@@@@",
        "@@@@@@@@@@@@@@@@@.........@@@@@@@.............@@@@@@............@@@@@...............@@@@@@@@@@@@@",
        "@@@@@@@@@@@@@@@@@............@@@.............@@@@@@@.............@@@@@.............@@@@@@@@@@@@@@",
        "@@@@@@@@@@@@@@@@@@...........@@@.............@@@@@@@..............@@@@..........@@@@@@@@@@@@@@@@@",
        "@@@@@@@@@@@@@@@@@@..........@@@@@.............@@@@@@..............@@@@..........@@@@@@@@@@@@@@@@@",
        "@@@@@@@@@@@@@@@@@............@...............@@.@@@@...............@@@...........@@@@@@@@@@@@@@@@",
        "@@@@@@@@@@@@@@@@@.................................@@...............@@@............@@@@@@@@@@@@@@@",
        "@@@@@@@@@@@@@@@@@@@....@.@.@@......................@................@@@......@...@@@@@@@@@@@@@@@@",
        "@@@@@@@@@@@@@@@@@@@@@@@@@@@@@........................................@@.@@..@@@.@@@@@@@@@@@@@@@@@",
        "@@@@@@@@@@@@@@@@@@@@@@@@@@@@@@.......................................@@@@@@@@@@@@@@@@@@@@@@@@@@@@",
        "@@@@@@@@@@@@@@@@@@@@@@@@@@@@.@@@......................................@@@@@@@@@@@@@@@@@@@@@@@@@@@",
        "@@@@@@@@@@@@@@@@@@@@@@@@@@@...........................................@@@@@@@@@@@@@@@@@@@@@@@@@@@",
        "@@@@@@@@@@@@@@@@@@@@@@@@@@@...........................@................@@@@@@@@@@@@@@@@@@@@@@@@@@",
        "@@@@@@@@@@@@@@@@@@@@@@@@@@@................@.........@@@@..............@@@@@@@@@@@@@@@@@@@@@@@@@@",
        "@@@@@@@@@@@@@@@@@@@@@@@@@@@@..............@@.........@@@...............@@@@@@@@@@@@@@@@@@@@@@@@@@",
        "@@@@@@@@@@@@@@@@@@@@@@@@@@@@@.............@..........................@@@@@@@@@@@@@@@@@@@@@@@@@@@@",
        "@@@@@@@@@@@@@@@@@@@@@@@@@@@@@@@...........@@.......................@@@@@@@@@@@@@@@@@@@@@@@@@@@@@@",
        "@@@@@@@@@@@@@@@@@@@@@@@@@@@@@@@@@.........@@.....................@@@@@@@@@@@@@@@@@@@@@@@@@@@@@@@@",
        "@@@@@@@@@@@@@@@@@@@@@@@@@@@@@@@@@@@@.@....@@...@@@@.........@.@@@@@@@@@@@@@@@@@@@@@@@@@@@@@@@@@@@",
        "@@@@@@@@@@@@@@@@@@@@@@@@@@@@@@@@@@@@@@@........@@@@........@@@@@@@@@@@@@@@@@@@@@@@@@@@@@@@@@@@@@@"
    ]
}