{
    "name": "room-32-32-4",
    "n_row": 32,
    "n_col": 32,
    "layout": [
        "@@@.@.@@@.@@@.@@@.@@@.@@@.@@@.@@",
        "@...@.......@...@.......@...@...",
        "@...@...@...@.......@...@.......",
        "....@...@.......@...@.......@...",
        "@@@.@@.@@@@.@@.@@@@@@@@@@@@.@@.@",
        "@.......@...........@...@...@...",
        "....@.......@...@...@...@.......",
        "@...@...@...@...@.......@...@...",
        "@@@@@@.@@@@@@@.@@@.@@@@.@.@@@@@.",
        "....@.......@.......@.......@...",
        "@.......@...@...@...@...@.......",
        "@...@...@.......@.......@...@...",
        "@@@@@.@@@.@@@@@@@@.@@@.@@@@.@@@.",
        "@...@.......@...@.......@...@...",
        "@...@...@...........@...@.......",
        "....@...@...@...@...@...@...@...",
        "@@.@@@.@@@@.@@@@@@.@@@.@@@@.@@@.",
        "....@...@...@...@.......@...@...",
        "@...@.......@.......@...........",
        "@.......@...@...@...@...@...@...",
        "@@.@@@@@@.@@@@@@@@@@@@.@@@@.@@@.",
        "@...@.......@...@.......@...@...",
        "@.......@...@.......@...@...@...",
        "....@...@.......@...@...@.......",
        "@.@@@@@@@@@.@@@.@.@@@@@.@@@.@@.@",
        "@...@...@...@...@...@.......@...",
        "........@...@...@.......@...@...",
        "@...@...@...........@...@...@...",
        "@@@.@@@@@@.@@@@@@@.@@@@.@@@.@@@.",
        "....@...@...@...@...@...@...@...",
        "@...........@...@...@...@...@...",
        "@...@...@...@..................."
    ]
}