{
    "name": "warehouse_small_narrow",
    "n_row": 33,
    "n_col": 57,
    "layout": [
        "@@......@@@....@@@....@@@....@@@....@@@....@@@....@@@..@@",
        "@@.....w@@@w..w@@@w..w@@@w..w@@@w..w@@@w..w@@@w..w@@@w.@@",
        "........@@@....@@@....@@@....@@@....@@@....@@@....@@@....",
        ".w.......................................................",
        "@@@..eee.eee.eee.eee.eee.eee.eee.eee.eee.eee.eee.eee...w.",
        "@@@.e@@@e@@@e@@@e@@@e@@@e@@@e@@@e@@@e@@@e@@@e@@@e@@@e.@@@",
        "@@@.e@@@e@@@e@@@e@@@e@@@e@@@e@@@e@@@e@@@e@@@e@@@e@@@e.@@@",
        ".w...eee.eee.eee.eee.eee.eee.eee.eee.eee.eee.eee.eee..@@@",
        "....e@@@e@@@e@@@e@@@e@@@e@@@e@@@e@@@e@@@e@@@e@@@e@@@e..w.",
        "....e@@@e@@@e@@@e@@@e@@@e@@@e@@@e@@@e@@@e@@@e@@@e@@@e....",
        ".w...eee.eee.eee.eee.eee.eee.eee.eee.eee.eee.eee.eee.....",
        "@@@.e@@@e@@@e@@@e@@@e@@@e@@@e@@@e@@@e@@@e@@@e@@@e@@@e..w.",
        "@@@.e@@@e@@@e@@@e@@@e@@@e@@@e@@@e@@@e@@@e@@@e@@@e@@@e.@@@",
        "@@@..eee.eee.eee.eee.eee.eee.eee.eee.eee.eee.eee.eee..@@@",
        ".w..e@@@e@@@e@@@e@@@e@@@e@@@e@@@e@@@e@@@e@@@e@@@e@@@e.@@@",
        "....e@@@e@@@e@@@e@@@e@@@e@@@e@@@e@@@e@@@e@@@e@@@e@@@e..w.",
        ".....eee.eee.eee.eee.eee.eee.eee.eee.eee.eee.eee.eee.....",
        ".w..e@@@e@@@e@@@e@@@e@@@e@@@e@@@e@@@e@@@e@@@e@@@e@@@e....",
        "@@@.e@@@e@@@e@@@e@@@e@@@e@@@e@@@e@@@e@@@e@@@e@@@e@@@e..w.",
        "@@@..eee.eee.eee.eee.eee.eee.eee.eee.eee.eee.eee.eee..@@@",
        "@@@.e@@@e@@@e@@@e@@@e@@@e@@@e@@@e@@@e@@@e@@@e@@@e@@@e.@@@",
        ".w..e@@@e@@@e@@@e@@@e@@@e@@@e@@@e@@@e@@@e@@@e@@@e@@@e.@@@",
        ".....eee.eee.eee.eee.eee.eee.eee.eee.eee.eee.eee.eee...w.",
        "....e@@@e@@@e@@@e@@@e@@@e@@@e@@@e@@@e@@@e@@@e@@@e@@@e....",
        ".w..e@@@e@@@e@@@e@@@e@@@e@@@e@@@e@@@e@@@e@@@e@@@e@@@e....",
        "@@@..eee.eee.eee.eee.eee.eee.eee.eee.eee.eee.eee.eee...w.",
        "@@@.e@@@e@@@e@@@e@@@e@@@e@@@e@@@e@@@e@@@e@@@e@@@e@@@e.@@@",
        "@@@.e@@@e@@@e@@@e@@@e@@@e@@@e@@@e@@@e@@@e@@@e@@@e@@@e.@@@",
        ".w...eee.eee.eee.eee.eee.eee.eee.eee.eee.eee.eee.eee..@@@",
        ".......................................................w.",
        "....@@@....@@@....@@@....@@@....@@@....@@@....@@@........",
        "@@.w@@@w..w@@@w..w@@@w..w@@@w..w@@@w..w@@@w..w@@@w.....@@",
        "@@..@@@....@@@....@@@....@@@....@@@....@@@....@@@......@@"
    ]
}