{
    "name": "warehouse_60x100",
    "n_row": 60,
    "n_col": 100,
    "layout": [
        "@@@@...@@@....@@@....@@@....@@@....@@@....@@@....@@@....@@@....@@@....@@@....@@@....@@@....@@@..@@@@",
        "@@@@..w@@@w..w@@@w..w@@@w..w@@@w..w@@@w..w@@@w..w@@@w..w@@@w..w@@@w..w@@@w..w@@@w..w@@@w..w@@@w.@@@@",
        "@@@@...@@@....@@@....@@@....@@@....@@@....@@@....@@@....@@@....@@@....@@@....@@@....@@@....@@@..@@@@",
        "@@@@............................................................................................@@@@",
        "....................................................................................................",
        ".w..................................................................................................",
        "@@@.................................................................................................",
        "@@@.....eee.eee.eee.eee.eee.eee.eee.eee.eee.eee.eee.eee.eee.eee.eee.eee.eee.eee.eee.eee.eee.........",
        "@@@....e@@@e@@@e@@@e@@@e@@@e@@@e@@@e@@@e@@@e@@@e@@@e@@@e@@@e@@@e@@@e@@@e@@@e@@@e@@@e@@@e@@@e......w.",
        ".w.....e@@@e@@@e@@@e@@@e@@@e@@@e@@@e@@@e@@@e@@@e@@@e@@@e@@@e@@@e@@@e@@@e@@@e@@@e@@@e@@@e@@@e.....@@@",
        "........eee.eee.eee.eee.eee.eee.eee.eee.eee.eee.eee.eee.eee.eee.eee.eee.eee.eee.eee.eee.eee......@@@",
        ".......e@@@e@@@e@@@e@@@e@@@e@@@e@@@e@@@e@@@e@@@e@@@e@@@e@@@e@@@e@@@e@@@e@@@e@@@e@@@e@@@e@@@e.....@@@",
        ".w.....e@@@e@@@e@@@e@@@e@@@e@@@e@@@e@@@e@@@e@@@e@@@e@@@e@@@e@@@e@@@e@@@e@@@e@@@e@@@e@@@e@@@e......w.",
        "@@@.....eee.eee.eee.eee.eee.eee.eee.eee.eee.eee.eee.eee.eee.eee.eee.eee.eee.eee.eee.eee.eee.........",
        "@@@....e@@@e@@@e@@@e@@@e@@@e@@@e@@@e@@@e@@@e@@@e@@@e@@@e@@@e@@@e@@@e@@@e@@@e@@@e@@@e@@@e@@@e........",
        "@@@....e@@@e@@@e@@@e@@@e@@@e@@@e@@@e@@@e@@@e@@@e@@@e@@@e@@@e@@@e@@@e@@@e@@@e@@@e@@@e@@@e@@@e......w.",
        ".w......eee.eee.eee.eee.eee.eee.eee.eee.eee.eee.eee.eee.eee.eee.eee.eee.eee.eee.eee.eee.eee......@@@",
        ".......e@@@e@@@e@@@e@@@e@@@e@@@e@@@e@@@e@@@e@@@e@@@e@@@e@@@e@@@e@@@e@@@e@@@e@@@e@@@e@@@e@@@e.....@@@",
        ".......e@@@e@@@e@@@e@@@e@@@e@@@e@@@e@@@e@@@e@@@e@@@e@@@e@@@e@@@e@@@e@@@e@@@e@@@e@@@e@@@e@@@e.....@@@",
        ".w......eee.eee.eee.eee.eee.eee.eee.eee.eee.eee.eee.eee.eee.eee.eee.eee.eee.eee.eee.eee.eee.......w.",
        "@@@....e@@@e@@@e@@@e@@@e@@@e@@@e@@@e@@@e@@@e@@@e@@@e@@@e@@@e@@@e@@@e@@@e@@@e@@@e@@@e@@@e@@@e........",
        "@@@....e@@@e@@@e@@@e@@@e@@@e@@@e@@@e@@@e@@@e@@@e@@@e@@@e@@@e@@@e@@@e@@@e@@@e@@@e@@@e@@@e@@@e........",
        "@@@.....eee.eee.eee.eee.eee.eee.eee.eee.eee.eee.eee.eee.eee.eee.eee.eee.eee.eee.eee.eee.eee.......w.",
        ".w.....e@@@e@@@e@@@e@@@e@@@e@@@e@@@e@@@e@@@e@@@e@@@e@@@e@@@e@@@e@@@e@@@e@@@e@@@e@@@e@@@e@@@e.....@@@",
        ".......e@@@e@@@e@@@e@@@e@@@e@@@e@@@e@@@e@@@e@@@e@@@e@@@e@@@e@@@e@@@e@@@e@@@e@@@e@@@e@@@e@@@e.....@@@",
        "........eee.eee.eee.eee.eee.eee.eee.eee.eee.eee.eee.eee.eee.eee.eee.eee.eee.eee.eee.eee.eee......@@@",
        ".w.....e@@@e@@@e@@@e@@@e@@@e@@@e@@@e@@@e@@@e@@@e@@@e@@@e@@@e@@@e@@@e@@@e@@@e@@@e@@@e@@@e@@@e......w.",
        "@@@....e@@@e@@@e@@@e@@@e@@@e@@@e@@@e@@@e@@@e@@@e@@@e@@@e@@@e@@@e@@@e@@@e@@@e@@@e@@@e@@@e@@@e........",
        "@@@.....eee.eee.eee.eee.eee.eee.eee.eee.eee.eee.eee.eee.eee.eee.eee.eee.eee.eee.eee.eee.eee.........",
        "@@@....e@@@e@@@e@@@e@@@e@@@e@@@e@@@e@@@e@@@e@@@e@@@e@@@e@@@e@@@e@@@e@@@e@@@e@@@e@@@e@@@e@@@e......w.",
        ".w.....e@@@e@@@e@@@e@@@e@@@e@@@e@@@e@@@e@@@e@@@e@@@e@@@e@@@e@@@e@@@e@@@e@@@e@@@e@@@e@@@e@@@e.....@@@",
        "........eee.eee.eee.eee.eee.eee.eee.eee.eee.eee.eee.eee.eee.eee.eee.eee.eee.eee.eee.eee.eee......@@@",
        ".......e@@@e@@@e@@@e@@@e@@@e@@@e@@@e@@@e@@@e@@@e@@@e@@@e@@@e@@@e@@@e@@@e@@@e@@@e@@@e@@@e@@@e.....@@@",
        ".w.....e@@@e@@@e@@@e@@@e@@@e@@@e@@@e@@@e@@@e@@@e@@@e@@@e@@@e@@@e@@@e@@@e@@@e@@@e@@@e@@@e@@@e......w.",
        "@@@.....eee.eee.eee.eee.eee.eee.eee.eee.eee.eee.eee.eee.eee.eee.eee.eee.eee.eee.eee.eee.eee.........",
        "@@@....e@@@e@@@e@@@e@@@e@@@e@@@e@@@e@@@e@@@e@@@e@@@e@@@e@@@e@@@e@@@e@@@e@@@e@@@e@@@e@@@e@@@e........",
        "@@@....e@@@e@@@e@@@e@@@e@@@e@@@e@@@e@@@e@@@e@@@e@@@e@@@e@@@e@@@e@@@e@@@e@@@e@@@e@@@e@@@e@@@e......w.",
        ".w......eee.eee.eee.eee.eee.eee.eee.eee.eee.eee.eee.eee.eee.eee.eee.eee.eee.eee.eee.eee.eee......@@@",
        ".......e@@@e@@@e@@@e@@@e@@@e@@@e@@@e@@@e@@@e@@@e@@@e@@@e@@@e@@@e@@@e@@@e@@@e@@@e@@@e@@@e@@@e.....@@@",
        ".......e@@@e@@@e@@@e@@@e@@@e@@@e@@@e@@@e@@@e@@@e@@@e@@@e@@@e@@@e@@@e@@@e@@@e@@@e@@@e@@@e@@@e.....@@@",
        ".w......eee.eee.eee.eee.eee.eee.eee.eee.eee.eee.eee.eee.eee.eee.eee.eee.eee.eee.eee.eee.eee.......w.",
        "@@@....e@@@e@@@e@@@e@@@e@@@e@@@e@@@e@@@e@@@e@@@e@@@e@@@e@@@e@@@e@@@e@@@e@@@e@@@e@@@e@@@e@@@e........",
        "@@@....e@@@e@@@e@@@e@@@e@@@e@@@e@@@e@@@e@@@e@@@e@@@e@@@e@@@e@@@e@@@e@@@e@@@e@@@e@@@e@@@e@@@e........",
        "@@@.....eee.eee.eee.eee.eee.eee.eee.eee.eee.eee.eee.eee.eee.eee.eee.eee.eee.eee.eee.eee.eee.......w.",
        ".w.....e@@@e@@@e@@@e@@@e@@@e@@@e@@@e@@@e@@@e@@@e@@@e@@@e@@@e@@@e@@@e@@@e@@@e@@@e@@@e@@@e@@@e.....@@@",
        ".......e@@@e@@@e@@@e@@@e@@@e@@@e@@@e@@@e@@@e@@@e@@@e@@@e@@@e@@@e@@@e@@@e@@@e@@@e@@@e@@@e@@@e.....@@@",
        "........eee.eee.eee.eee.eee.eee.eee.eee.eee.eee.eee.eee.eee.eee.eee.eee.eee.eee.eee.eee.eee......@@@",
        ".w.....e@@@e@@@e@@@e@@@e@@@e@@@e@@@e@@@e@@@e@@@e@@@e@@@e@@@e@@@e@@@e@@@e@@@e@@@e@@@e@@@e@@@e......w.",
        "@@@....e@@@e@@@e@@@e@@@e@@@e@@@e@@@e@@@e@@@e@@@e@@@e@@@e@@@e@@@e@@@e@@@e@@@e@@@e@@@e@@@e@@@e........",
        "@@@.....eee.eee.eee.eee.eee.eee.eee.eee.eee.eee.eee.eee.eee.eee.eee.eee.eee.eee.eee.eee.eee.........",
        "@@@....e@@@e@@@e@@@e@@@e@@@e@@@e@@@e@@@e@@@e@@@e@@@e@@@e@@@e@@@e@@@e@@@e@@@e@@@e@@@e@@@e@@@e......w.",
        ".w.....e@@@e@@@e@@@e@@@e@@@e@@@e@@@e@@@e@@@e@@@e@@@e@@@e@@@e@@@e@@@e@@@e@@@e@@@e@@@e@@@e@@@e.....@@@",
        "........eee.eee.eee.eee.eee.eee.eee.eee.eee.eee.eee.eee.eee.eee.eee.eee.eee.eee.eee.eee.eee......@@@",
        ".................................................................................................@@@",
        "..................................................................................................w.",
        "....................................................................................................",
        "@@@@............................................................................................@@@@",
        "@@@@..@@@....@@@....@@@....@@@....@@@....@@@....@@@....@@@....@@@....@@@....@@@....@@@....@@@...@@@@",
        "@@@@.w@@@w..w@@@w..w@@@w..w@@@w..w@@@w..w@@@w..w@@@w..w@@@w..w@@@w..w@@@w..w@@@w..w@@@w..w@@@w..@@@@",
        "@@@@..@@@....@@@....@@@....@@@....@@@....@@@....@@@....@@@....@@@....@@@....@@@....@@@....@@@...@@@@"
    ]
}