type octile
height 97
width 97
map
@@@@@@@@@@@@@@@@@@@@@@@@@@@@@@@@@@@@@@@@@@@@@@@@@@@@@@@@@@@@@@@@@@@@@@@@@@@@@@@@@@@@@@@@@@@@@@@@@
@@@@@@@@@@@@@@@@@@@@@@@@@@@@@@@@@@@@@@@@@@@@@@@@@@@@@@@@@@@@@@@@@@@@@@@@@@@@@@@@@@@@@@@@@@@@@@@@@
@@@@@@@@@@@@@@@@@@@@@@@@@@@@@@@@@@@@@@@@@@@@@@@@@@@@@@@@@@@@@@@@@@@@@@@@@@@@@@@@@@@@@@@@@@@@@@@@@
@@@@@@@@@@@@@@@@@@@@@@@@@@@@@@@@@@@@@@@@@@@@@@@@@@@@@@@@@@@@@@@@@@@@@@@@@@@@@@@@@@@@@@@@@@@@@@@@@
@@@@@@@@@@@@@@@@@@@@@@@@@@@@@@@@@@@@@@@@@@@@@@@@@@@@@@@@@@@@@@@@@@@@@@@@@@@@@@@@@@@@@@@@@@@@@@@@@
@@@@@@@@@@@@@@@@@@@@@@@@@@@@@@@@@@@@@@@@@@@@@@@@@@@@@@@@@@@@@@@@@@@@@@@@@@@@@@@@@@@@@@@@@@@@@@@@@
@@@@@@@@@@@@@@@@@@@@@@@@@@@@@@@@@@@@@@@@@@@@@@@@@@@@@@@@@@@@@@@@@@@@@@@@@@@@@@@@@@@@@@@@@@@@@@@@@
@@@@@@@@@@@@@@@@@@@@@@@@@@@@@@@@@@@@@@@@@@@@@@@@@@@@@@@@@@@@@@@@@@@@@@@@@@@@@@@@@@@@@@@@@@@@@@@@@
@@@@@@@@@@@@@@@@@@@@@@@@@@@@@@@@@@@@@@@@@@@@@@@@@@@@@@@@@@@@@@@@@@@@@@@@@@@@@@@@@@@@@@@@@@@@@@@@@
@@@@@@@@@@@@@@@@@@@@@@@@@@@@@@@@@@@@@@@@@@@@@@@@@@@@@@@@@@@@@@@@@@@@@@@@@@@@@@@@@@@@@@@@@@@@@@@@@
@@@@@@@@@@@@@@@@@@@@@@@@@@@@@@@@@@@@@@@@@@@@@@@@@@@@@@@@@@@@@@@@@@@@@@@@.@@@@@@@@@@@@@@@@@@@@@@@@
@@@@@@@@@@@@@@@@@@@@@@@@@@@@@@@@@@@@@@@@@@@@@@@@@@@@@@@@@@@@@@@@@@@@@@@@...@@@@@@@@@@@@@@@@@@@@@@
@@@@@@@@@@@@@@@@@@@@@@@@@@@@@@@@@@@@@@@@@@@@@@@@@@@@@@@@@@@@@@@@@@@@@@@@.....@@@@@@@@@@@@@@@@@@@@
@@@@@@@@@@@@@@@@@@@@@@@@@@@@@@@@@@@@@@@@@@@@@@@@@@@@@@@@@@@@@@@@@@@@@@@@@......@@.@@@@@@@@@@@@@@@
@@@@@@@@@@@@@@@@@@@@@@@@@@@@@@@@@@@@@@@@@@@@@@@@@@@@@@@@@@@@@@@@@@@@@@@@............@@@@@@@@@@@@@
@@@@@@@@@@@@@@@@@@@@@@@@@@@@@@@@@@@@@@@@@@@@@@@@@@@@@@@@@@@@@@@@@@@@@@@............@@@@@@@@@@@@@@
@@@@@@@@@@@@@@@@@@@@@@@@@@@@@@@@@@@@@@@@@@@@@@@@@@@@@@@@@@@@@@@@@@@@@@@.............@@@@@@@@@@@@@
@@@@@@@@@@@@@@@@@@@@@@@@@@@@@@@@@@@@@@@@@@@@@@@@@@@@@@@@@@@@@@@@@@@@@@.......@@@@.@@@@@@@@@@@@@@@
@@@@@@@@@@@@@@@@@@@@@@@@@@@@@@@@@@@@@@@@@@@@@@@@@@@@@@@@@@@@@@@@@@@@@@......@@@@@@@@@@@@@@@@@@@@@
@@@@@@@@@@@@@@@@@@@@@@@@@@@@@@@@@@@@@@@@@@@@@@@@@@@@@@@@@@@@@@@@@@@@@.......@@@@@@@@@@@@@@@@@@@@@
@@@@@@@@@@@@@@@@@@@@@@@@@@@@@@@@@@@@@@@@@@@@@@@@@@@@@@@@@@@@@@@@@@@@@.......@@@@@@@@@@@@@@@@@@@@@
@@@@@@@@@@@@@@@@@@@@@@@@@@@@@@@@@@@@@@@@@@@@@@@@@@@@@@@@@@@@@@@@@@@@.........@@@@@@@@...@@@@@@@@@
@@@@@@@@@@@@@@@@@@@@@@@@@@@@@@@@@@@@@@@@@@@@@@@@@@@@@@@@@@@@@@@@@@.......@@..@@@@@@.....@@@@@@@@@
@@@@@@@@@@@@@@@@@@@@@@@@@@@@@@@@@@@@@@@@@@@@@@@@@@@@@@@@@@@@@@@@@.......@@@@.@@@@@.....@@@@@@@@@@
@@@@@@@@@@@@@@@@@@@@@@@@@@@@@@@@@@@@@@@@@@@@@@@@@@@@@@@@@@@@@@@@.........@@..@@@......@@@@@@@@@@@
@@@@@@@@@@@@@@@@@@@@@@@@@@@@@@@@@@@@@@@@@@@@@@@@@@@@@@@@@@@@@@@..........@..........@@@@@@@@@@@@@
@@@@@@@@@@@@@@@@@@@@@@@@@@@@@@@@@@@@@@@@@@@@@@@@@@@@@@@@@@@@@@@...................@@@@@@@@@@@@@@@
@@@@@@@@@@@@@@@@@@@@@@@@@@@@@@@@@@@@@@@@@@@@@@@@@@@@@@@@@@@@@@...................@@@@@@@@@@.@@@@@
@@@@@@@@@@@@@@@@@@@@@@@@@@@@@@@@@@@@@@@@@@@@@@@@@@@@@@@@@@@@@@.................@@@@@@@@@@@@.@@@@@
@@@@@@@@@@@@@@@@@@@@@@@@@@@@@@@@@@@@@@@@@@@@.....@@..@@@@@@@@..@@........@@.....@@@@@..@@....@@@@
@@@@@@@@@@@@@@@@@@@@@@@@@@@@@@@@@@@@@@@@.........@@@.....@@@@.@@@@......@@@@@.@@@@@@.........@@@@
@@@@@@@@@@@@@@@@@@@@@@@@@@@@@@@@@@@@@@@@...........@......@@@@@@@@......@@@@@@@@@@@@..........@@@
@@@@@@@@@@@@@@@@@@@@@@@@@@@@@@@@@@@@@.....................@@@@@@@@@.....@@@@@@@.@@@@......@@@@.@@
@@@@@@@@@@@@@@@@@@@@@@@@@@@@@@@@@@@@.....................@@@@.@@@@@......@@@@@...@........@@@@.@@
@@@@@@@@@@@@@@@@@@@@@@@@@@@@@@@@@@@.....................@@@@@..@@@@@....@@@@@.............@@@..@@
@@@@@@@@@@@@@@@@@@@@@@@@@@@@@@@@@@@@@...................@@@@....@@@@@...@@@@@..................@@
@@@@@@@@@@@@@@@@@@@@@@@@@@@@@@@@@.@@.....................@@....@@@@@@@@...@@@@..................@
@@@@@@@@@@@@@@@@@@@@@@@@@@@@@@@@........................@@....@@@@@@@@....@@@@..................@
@@@@@@@@@@@@@@@@@@@@@@@@@@@@@@@@@.......................@....@@@@@@@@@......@@.......@@@....@@@@@
@@@@@@@@@@@@@@@@@@@@@@@@@@@@@@@@@..............@............@@@@..@@@@......@@.......@@.....@@@@.
@@@@@@@@@@@@@@@@@@@@@@@@@@@@@@@@@..............@@@.........@@@@....@@@@.....................@....
@@@@@@@@@@@@@@@@@@@@@@@@@@@@@@@@@@@..........@@@@..........@.......@@@@..........................
@@@@@@@@@@@@@@@@@@@@@@@@@@@@@@@@@@@........@@@@@....................@@.......@@..................
@@@@@@@@@@@@@@@@@@@@@@@@@@@@@@@@@@@.......@@@@@@....................@@.......@@@.................
@@@@@@@@@@@@@@@@@@@@@@@@@@@@@@@@@@@......@@.........................@@......@@@@.................
@@@@@@@@@@@@@@@@@@@@@@@@@@@@@@@@@@@@@....@@..............@..........@@......@@@@..@@@@...@@@@....
@@@@@@@@@@@@@@@@@@@@@@@@@@@@@@@@@@@@.....@@@.........................@@.....@@@@.@@@@@@@.@@@@@...
@@@@@@@@@@@@@@@@@@@@@@@@@@@@@@@@@@@@.....@@@............@@..........@@@......@@@@@@@@@@..@@@@@.@@
@@@@@@@@@@@@@@@@@@@@@@@@@@@@@@@@@@@@....@@@.....@.......@@..........@@@@......@@@@@@@@@@@@@@@@@@@
@@@@@@@@@@@@@@@@@@@@@@@@@@@@@.@@.@@....@@@............@@@@..........@@@@......@@@@@@@@@@@@@@@@@@@
@@@@@@@@@@@@@@@@@@@@@@@@@@@@@..........@@@@.........@@@@@............@@.......@@@.@@@@@@@@@@@.@@@
@@@@@@@@@@@@@@@@@@@@@@@@@@@@@..........@@@@............@............@@@.......@@...@@@..@@@...@@@
@@@@@@@@@@@@@@@@@@@@@@@@@@@@@...........@@............@@............@@.......@@@...@@@..@@@...@@@
@@@@@@@@@@@@@@@@@@@@@@@@@@@@@.@@@..............@.@@@..@@............@@.......@@@....@@..@@@...@@@
@@@@@@@@@@@@@@@@@@@@@@@@@@@@@@@@@@............@@....@@@.............@@.......@@@@...............@
@@@@@@@@@@@@@@@@@@@@@@@@@@@@@@@@@@...........@@@@@@@@@.............@@........@@..................
@@@@@@@@@@@@@@@@@@@@@@@@@@@@@@@@@............@@@@@.................@@...........................@
@@@@@@@@@@@@@@@@@@@@@@@@@@@@@@@@@@............@@@.................@@@.......................@@@@@
@@@@@@@@@@@@@@@@@@@@@@@@@@@@@@@@@@...............................@@@@......@@@.......@@@....@@@@@
@@@@@@@@@@@@@@@@@@@@@@@@@@@@@@@@@@...............................@@@@......@@@@@......@@......@@@
@@@@@@@@@@@@@@@@@@@@@@@@@@@@@@@@.................................@@@@......@@@@@................@
@@@@@@@@@@@@@@@@@@@@@@@@@@@@@.@@@...............................@@@........@@@@.................@
@@@@@@@@@@@@@@@@@@@@@@@@@@@....@@..............................@@@.........@@@...............@.@@
@@@@@@@@@@@@@@@@@@@@@@@@@@............@.......................@@@.........@@@@...@..........@@@@@
@@@@@@@@@@@@@@@@@@@@@@@@...........@..@@@@@@.................@@@..........@@@@@.@@@@........@@@@@
@@@@@@@@@@@@@@@@@@@@@@@...........@@@@@@@@@@@..........@@.@@@@@..........@@@@@@@@@@@........@@@@@
@@@@@@@@@@@@@@@@@@@@@@.............@@@@@@@@@@........@@@@@@@@@........@@@@@@@@@@@@@@@........@@@@
@@@@@@@@@@@@@@@@@@@@@@....@@@.......@@@@@@@@......@@@@@@@@@@@..........@@@...@@@@@@@@........@@@@
@@@@@@@@@@@@@@@@@@@@@.....@@@@......@@@@@@@@@@.@@@@@@@@@@@@@@.........@@@.....@@@@@@@@.@..@@.@@@@
@@@@@@@@@@@@@@@@@@@.......@@@@......@@...@@@@@@@@@@@@@@@...............@......@@@@@@@@@@@@@@@@@@@
@@@@@@@@@@@@@@@@@@.........@@@.....@@@.....@.@@@@@@....@............@...........@.@..@@@@@@@@@@@@
@@@@@@@@@@@@@@@@..................@@@...........@@................@@@@...............@@@@@@@@@@@@
@@@@@@@@@@@@@@....................@@............@@.............@@.@@@................@@@@@@@@@@@@
@@@@@@@@@@@@@@...................@@@..........................@@@@@@.................@@@@@@@@@@@@
@@@@@@@@@@@@@...................@@@..........................@@@@@@...................@@@@@@@@@@@
@@@@@@@@@@@@@@............@@@..@@@@..........................@@@@@.........@@.........@@@@@@@@@@@
@@@@@@@@@@@@@@@...........@@@@.@@@@..........................@@@@@.........@@@.......@@@@@@@@@@@@
@@@@@@@@@@@@@@@...........@@@@@@@..............@@@@...........@.@@@@........@@......@@@@@@@@@@@@@
@@@@@@@@@@@@@@@@@.........@@@@@@@.............@@@@@@............@@@@@...............@@@@@@@@@@@@@
@@@@@@@@@@@@@@@@@............@@@.............@@@@@@@.............@@@@@.............@@@@@@@@@@@@@@
@@@@@@@@@@@@@@@@@@...........@@@.............@@@@@@@..............@@@@..........@@@@@@@@@@@@@@@@@
@@@@@@@@@@@@@@@@@@..........@@@@@.............@@@@@@..............@@@@..........@@@@@@@@@@@@@@@@@
@@@@@@@@@@@@@@@@@............@...............@@.@@@@...............@@@...........@@@@@@@@@@@@@@@@
@@@@@@@@@@@@@@@@@.................................@@...............@@@............@@@@@@@@@@@@@@@
@@@@@@@@@@@@@@@@@@@....@.@.@@......................@................@@@......@...@@@@@@@@@@@@@@@@
@@@@@@@@@@@@@@@@@@@@@@@@@@@@@........................................@@.@@..@@@.@@@@@@@@@@@@@@@@@
@@@@@@@@@@@@@@@@@@@@@@@@@@@@@@.......................................@@@@@@@@@@@@@@@@@@@@@@@@@@@@
@@@@@@@@@@@@@@@@@@@@@@@@@@@@.@@@......................................@@@@@@@@@@@@@@@@@@@@@@@@@@@
@@@@@@@@@@@@@@@@@@@@@@@@@@@...........................................@@@@@@@@@@@@@@@@@@@@@@@@@@@
@@@@@@@@@@@@@@@@@@@@@@@@@@@...........................@................@@@@@@@@@@@@@@@@@@@@@@@@@@
@@@@@@@@@@@@@@@@@@@@@@@@@@@................@.........@@@@..............@@@@@@@@@@@@@@@@@@@@@@@@@@
@@@@@@@@@@@@@@@@@@@@@@@@@@@@..............@@.........@@@...............@@@@@@@@@@@@@@@@@@@@@@@@@@
@@@@@@@@@@@@@@@@@@@@@@@@@@@@@.............@..........................@@@@@@@@@@@@@@@@@@@@@@@@@@@@
@@@@@@@@@@@@@@@@@@@@@@@@@@@@@@@...........@@.......................@@@@@@@@@@@@@@@@@@@@@@@@@@@@@@
@@@@@@@@@@@@@@@@@@@@@@@@@@@@@@@@@.........@@.....................@@@@@@@@@@@@@@@@@@@@@@@@@@@@@@@@
@@@@@@@@@@@@@@@@@@@@@@@@@@@@@@@@@@@@.@....@@...@@@@.........@.@@@@@@@@@@@@@@@@@@@@@@@@@@@@@@@@@@@
@@@@@@@@@@@@@@@@@@@@@@@@@@@@@@@@@@@@@@@........@@@@........@@@@@@@@@@@@@@@@@@@@@@@@@@@@@@@@@@@@@@
