typW octilW
hWight 60
width 100
map
@@@@...@@@....@@@....@@@....@@@....@@@....@@@....@@@....@@@....@@@....@@@....@@@....@@@....@@@..@@@@
@@@@..W@@@W..W@@@W..W@@@W..W@@@W..W@@@W..W@@@W..W@@@W..W@@@W..W@@@W..W@@@W..W@@@W..W@@@W..W@@@W.@@@@
@@@@...@@@....@@@....@@@....@@@....@@@....@@@....@@@....@@@....@@@....@@@....@@@....@@@....@@@..@@@@
@@@@............................................................................................@@@@
....................................................................................................
.W..................................................................................................
@@@.................................................................................................
@@@.....EEE.EEE.EEE.EEE.EEE.EEE.EEE.EEE.EEE.EEE.EEE.EEE.EEE.EEE.EEE.EEE.EEE.EEE.EEE.EEE.EEE.........
@@@....E@@@E@@@E@@@E@@@E@@@E@@@E@@@E@@@E@@@E@@@E@@@E@@@E@@@E@@@E@@@E@@@E@@@E@@@E@@@E@@@E@@@E......W.
.W.....E@@@E@@@E@@@E@@@E@@@E@@@E@@@E@@@E@@@E@@@E@@@E@@@E@@@E@@@E@@@E@@@E@@@E@@@E@@@E@@@E@@@E.....@@@
........EEE.EEE.EEE.EEE.EEE.EEE.EEE.EEE.EEE.EEE.EEE.EEE.EEE.EEE.EEE.EEE.EEE.EEE.EEE.EEE.EEE......@@@
.......E@@@E@@@E@@@E@@@E@@@E@@@E@@@E@@@E@@@E@@@E@@@E@@@E@@@E@@@E@@@E@@@E@@@E@@@E@@@E@@@E@@@E.....@@@
.W.....E@@@E@@@E@@@E@@@E@@@E@@@E@@@E@@@E@@@E@@@E@@@E@@@E@@@E@@@E@@@E@@@E@@@E@@@E@@@E@@@E@@@E......W.
@@@.....EEE.EEE.EEE.EEE.EEE.EEE.EEE.EEE.EEE.EEE.EEE.EEE.EEE.EEE.EEE.EEE.EEE.EEE.EEE.EEE.EEE.........
@@@....E@@@E@@@E@@@E@@@E@@@E@@@E@@@E@@@E@@@E@@@E@@@E@@@E@@@E@@@E@@@E@@@E@@@E@@@E@@@E@@@E@@@E........
@@@....E@@@E@@@E@@@E@@@E@@@E@@@E@@@E@@@E@@@E@@@E@@@E@@@E@@@E@@@E@@@E@@@E@@@E@@@E@@@E@@@E@@@E......W.
.W......EEE.EEE.EEE.EEE.EEE.EEE.EEE.EEE.EEE.EEE.EEE.EEE.EEE.EEE.EEE.EEE.EEE.EEE.EEE.EEE.EEE......@@@
.......E@@@E@@@E@@@E@@@E@@@E@@@E@@@E@@@E@@@E@@@E@@@E@@@E@@@E@@@E@@@E@@@E@@@E@@@E@@@E@@@E@@@E.....@@@
.......E@@@E@@@E@@@E@@@E@@@E@@@E@@@E@@@E@@@E@@@E@@@E@@@E@@@E@@@E@@@E@@@E@@@E@@@E@@@E@@@E@@@E.....@@@
.W......EEE.EEE.EEE.EEE.EEE.EEE.EEE.EEE.EEE.EEE.EEE.EEE.EEE.EEE.EEE.EEE.EEE.EEE.EEE.EEE.EEE.......W.
@@@....E@@@E@@@E@@@E@@@E@@@E@@@E@@@E@@@E@@@E@@@E@@@E@@@E@@@E@@@E@@@E@@@E@@@E@@@E@@@E@@@E@@@E........
@@@....E@@@E@@@E@@@E@@@E@@@E@@@E@@@E@@@E@@@E@@@E@@@E@@@E@@@E@@@E@@@E@@@E@@@E@@@E@@@E@@@E@@@E........
@@@.....EEE.EEE.EEE.EEE.EEE.EEE.EEE.EEE.EEE.EEE.EEE.EEE.EEE.EEE.EEE.EEE.EEE.EEE.EEE.EEE.EEE.......W.
.W.....E@@@E@@@E@@@E@@@E@@@E@@@E@@@E@@@E@@@E@@@E@@@E@@@E@@@E@@@E@@@E@@@E@@@E@@@E@@@E@@@E@@@E.....@@@
.......E@@@E@@@E@@@E@@@E@@@E@@@E@@@E@@@E@@@E@@@E@@@E@@@E@@@E@@@E@@@E@@@E@@@E@@@E@@@E@@@E@@@E.....@@@
........EEE.EEE.EEE.EEE.EEE.EEE.EEE.EEE.EEE.EEE.EEE.EEE.EEE.EEE.EEE.EEE.EEE.EEE.EEE.EEE.EEE......@@@
.W.....E@@@E@@@E@@@E@@@E@@@E@@@E@@@E@@@E@@@E@@@E@@@E@@@E@@@E@@@E@@@E@@@E@@@E@@@E@@@E@@@E@@@E......W.
@@@....E@@@E@@@E@@@E@@@E@@@E@@@E@@@E@@@E@@@E@@@E@@@E@@@E@@@E@@@E@@@E@@@E@@@E@@@E@@@E@@@E@@@E........
@@@.....EEE.EEE.EEE.EEE.EEE.EEE.EEE.EEE.EEE.EEE.EEE.EEE.EEE.EEE.EEE.EEE.EEE.EEE.EEE.EEE.EEE.........
@@@....E@@@E@@@E@@@E@@@E@@@E@@@E@@@E@@@E@@@E@@@E@@@E@@@E@@@E@@@E@@@E@@@E@@@E@@@E@@@E@@@E@@@E......W.
.W.....E@@@E@@@E@@@E@@@E@@@E@@@E@@@E@@@E@@@E@@@E@@@E@@@E@@@E@@@E@@@E@@@E@@@E@@@E@@@E@@@E@@@E.....@@@
........EEE.EEE.EEE.EEE.EEE.EEE.EEE.EEE.EEE.EEE.EEE.EEE.EEE.EEE.EEE.EEE.EEE.EEE.EEE.EEE.EEE......@@@
.......E@@@E@@@E@@@E@@@E@@@E@@@E@@@E@@@E@@@E@@@E@@@E@@@E@@@E@@@E@@@E@@@E@@@E@@@E@@@E@@@E@@@E.....@@@
.W.....E@@@E@@@E@@@E@@@E@@@E@@@E@@@E@@@E@@@E@@@E@@@E@@@E@@@E@@@E@@@E@@@E@@@E@@@E@@@E@@@E@@@E......W.
@@@.....EEE.EEE.EEE.EEE.EEE.EEE.EEE.EEE.EEE.EEE.EEE.EEE.EEE.EEE.EEE.EEE.EEE.EEE.EEE.EEE.EEE.........
@@@....E@@@E@@@E@@@E@@@E@@@E@@@E@@@E@@@E@@@E@@@E@@@E@@@E@@@E@@@E@@@E@@@E@@@E@@@E@@@E@@@E@@@E........
@@@....E@@@E@@@E@@@E@@@E@@@E@@@E@@@E@@@E@@@E@@@E@@@E@@@E@@@E@@@E@@@E@@@E@@@E@@@E@@@E@@@E@@@E......W.
.W......EEE.EEE.EEE.EEE.EEE.EEE.EEE.EEE.EEE.EEE.EEE.EEE.EEE.EEE.EEE.EEE.EEE.EEE.EEE.EEE.EEE......@@@
.......E@@@E@@@E@@@E@@@E@@@E@@@E@@@E@@@E@@@E@@@E@@@E@@@E@@@E@@@E@@@E@@@E@@@E@@@E@@@E@@@E@@@E.....@@@
.......E@@@E@@@E@@@E@@@E@@@E@@@E@@@E@@@E@@@E@@@E@@@E@@@E@@@E@@@E@@@E@@@E@@@E@@@E@@@E@@@E@@@E.....@@@
.W......EEE.EEE.EEE.EEE.EEE.EEE.EEE.EEE.EEE.EEE.EEE.EEE.EEE.EEE.EEE.EEE.EEE.EEE.EEE.EEE.EEE.......W.
@@@....E@@@E@@@E@@@E@@@E@@@E@@@E@@@E@@@E@@@E@@@E@@@E@@@E@@@E@@@E@@@E@@@E@@@E@@@E@@@E@@@E@@@E........
@@@....E@@@E@@@E@@@E@@@E@@@E@@@E@@@E@@@E@@@E@@@E@@@E@@@E@@@E@@@E@@@E@@@E@@@E@@@E@@@E@@@E@@@E........
@@@.....EEE.EEE.EEE.EEE.EEE.EEE.EEE.EEE.EEE.EEE.EEE.EEE.EEE.EEE.EEE.EEE.EEE.EEE.EEE.EEE.EEE.......W.
.W.....E@@@E@@@E@@@E@@@E@@@E@@@E@@@E@@@E@@@E@@@E@@@E@@@E@@@E@@@E@@@E@@@E@@@E@@@E@@@E@@@E@@@E.....@@@
.......E@@@E@@@E@@@E@@@E@@@E@@@E@@@E@@@E@@@E@@@E@@@E@@@E@@@E@@@E@@@E@@@E@@@E@@@E@@@E@@@E@@@E.....@@@
........EEE.EEE.EEE.EEE.EEE.EEE.EEE.EEE.EEE.EEE.EEE.EEE.EEE.EEE.EEE.EEE.EEE.EEE.EEE.EEE.EEE......@@@
.W.....E@@@E@@@E@@@E@@@E@@@E@@@E@@@E@@@E@@@E@@@E@@@E@@@E@@@E@@@E@@@E@@@E@@@E@@@E@@@E@@@E@@@E......W.
@@@....E@@@E@@@E@@@E@@@E@@@E@@@E@@@E@@@E@@@E@@@E@@@E@@@E@@@E@@@E@@@E@@@E@@@E@@@E@@@E@@@E@@@E........
@@@.....EEE.EEE.EEE.EEE.EEE.EEE.EEE.EEE.EEE.EEE.EEE.EEE.EEE.EEE.EEE.EEE.EEE.EEE.EEE.EEE.EEE.........
@@@....E@@@E@@@E@@@E@@@E@@@E@@@E@@@E@@@E@@@E@@@E@@@E@@@E@@@E@@@E@@@E@@@E@@@E@@@E@@@E@@@E@@@E......W.
.W.....E@@@E@@@E@@@E@@@E@@@E@@@E@@@E@@@E@@@E@@@E@@@E@@@E@@@E@@@E@@@E@@@E@@@E@@@E@@@E@@@E@@@E.....@@@
........EEE.EEE.EEE.EEE.EEE.EEE.EEE.EEE.EEE.EEE.EEE.EEE.EEE.EEE.EEE.EEE.EEE.EEE.EEE.EEE.EEE......@@@
.................................................................................................@@@
..................................................................................................W.
....................................................................................................
@@@@............................................................................................@@@@
@@@@..@@@....@@@....@@@....@@@....@@@....@@@....@@@....@@@....@@@....@@@....@@@....@@@....@@@...@@@@
@@@@.W@@@W..W@@@W..W@@@W..W@@@W..W@@@W..W@@@W..W@@@W..W@@@W..W@@@W..W@@@W..W@@@W..W@@@W..W@@@W..@@@@
@@@@..@@@....@@@....@@@....@@@....@@@....@@@....@@@....@@@....@@@....@@@....@@@....@@@....@@@...@@@@
