{
    "name": "sortation_small",
    "n_row": 33,
    "n_col": 57,
    "layout": [
        "@@@@.................................................@@@@",
        "@@@@.................................................@@@@",
        "@@@@.................................................@@@@",
        "@@@@.................................................@@@@",
        ".........................................................",
        ".........................................................",
        "......@.@.@.@.@.@.@.@.@.@.@.@.@.@.@.@.@.@.@.@.@.@.@......",
        ".........................................................",
        "......@.@.@.@.@.@.@.@.@.@.@.@.@.@.@.@.@.@.@.@.@.@.@......",
        ".........................................................",
        "......@.@.@.@.@.@.@.@.@.@.@.@.@.@.@.@.@.@.@.@.@.@.@......",
        ".........................................................",
        "......@.@.@.@.@.@.@.@.@.@.@.@.@.@.@.@.@.@.@.@.@.@.@......",
        ".........................................................",
        "......@.@.@.@.@.@.@.@.@.@.@.@.@.@.@.@.@.@.@.@.@.@.@......",
        ".........................................................",
        "......@.@.@.@.@.@.@.@.@.@.@.@.@.@.@.@.@.@.@.@.@.@.@......",
        ".........................................................",
        "......@.@.@.@.@.@.@.@.@.@.@.@.@.@.@.@.@.@.@.@.@.@.@......",
        ".........................................................",
        "......@.@.@.@.@.@.@.@.@.@.@.@.@.@.@.@.@.@.@.@.@.@.@......",
        ".........................................................",
        "......@.@.@.@.@.@.@.@.@.@.@.@.@.@.@.@.@.@.@.@.@.@.@......",
        ".........................................................",
        "......@.@.@.@.@.@.@.@.@.@.@.@.@.@.@.@.@.@.@.@.@.@.@......",
        ".........................................................",
        "......@.@.@.@.@.@.@.@.@.@.@.@.@.@.@.@.@.@.@.@.@.@.@......",
        ".........................................................",
        ".........................................................",
        "@@@@.................................................@@@@",
        "@@@@.................................................@@@@",
        "@@@@.................................................@@@@",
        "@@@@.................................................@@@@"
    ]
}